Bioloid	KEYWORD1
BioloidController	KEYWORD1
BioloidIK	KEYWORD1
ax12Init	KEYWORD2
ax12GetRegister	KEYWORD2
ax12SetRegister	KEYWORD2
ax12SetRegister2	KEYWORD2
ax12SetPosition	KEYWORD2
SetPosition	KEYWORD2
GetPosition	KEYWORD2
TorqueOn	KEYWORD2
Relax KEYWORD2
PlayTone KEYWORD2
loadPose	KEYWORD2   
readPose	KEYWORD2
writePose	KEYWORD2   
interpolateSetup	KEYWORD2
interpolateStep	KEYWORD2
interpolating	KEYWORD2
WaitServosMoving	KEYWORD2


AX_MODEL_NUMBER_L	LITERAL1
AX_MODEL_NUMBER_H	LITERAL1
AX_VERSION	LITERAL1
AX_ID	LITERAL1
AX_BAUD_RATE	LITERAL1
AX_RETURN_DELAY_TIME	LITERAL1
AX_CW_ANGLE_LIMIT_L	LITERAL1
AX_CW_ANGLE_LIMIT_H	LITERAL1
AX_CCW_ANGLE_LIMIT_L	LITERAL1
AX_CCW_ANGLE_LIMIT_H	LITERAL1
AX_SYSTEM_DATA2	LITERAL1
AX_LIMIT_TEMPERATURE	LITERAL1
AX_DOWN_LIMIT_VOLTAGE	LITERAL1
AX_UP_LIMIT_VOLTAGE	LITERAL1
AX_MAX_TORQUE_L	LITERAL1
AX_MAX_TORQUE_H	LITERAL1
AX_RETURN_LEVEL	LITERAL1
AX_ALARM_LED	LITERAL1
AX_ALARM_SHUTDOWN	LITERAL1
AX_OPERATING_MODE	LITERAL1
AX_DOWN_CALIBRATION_L	LITERAL1
AX_DOWN_CALIBRATION_H	LITERAL1
AX_UP_CALIBRATION_L	LITERAL1
AX_UP_CALIBRATION_H	LITERAL1

AX_TORQUE_ENABLE	LITERAL1
AX_LED	LITERAL1
AX_CW_COMPLIANCE_MARGIN	LITERAL1
AX_CCW_COMPLIANCE_MARGIN	LITERAL1
AX_CW_COMPLIANCE_SLOPE	LITERAL1
AX_CCW_COMPLIANCE_SLOPE	LITERAL1
AX_GOAL_POSITION_L	LITERAL1
AX_GOAL_POSITION_H	LITERAL1
AX_GOAL_SPEED_L	LITERAL1
AX_GOAL_SPEED_H	LITERAL1
AX_TORQUE_LIMIT_L	LITERAL1
AX_TORQUE_LIMIT_H	LITERAL1
AX_PRESENT_POSITION_L	LITERAL1
AX_PRESENT_POSITION_H	LITERAL1
AX_PRESENT_SPEED_L	LITERAL1
AX_PRESENT_SPEED_H	LITERAL1
AX_PRESENT_LOAD_L	LITERAL1
AX_PRESENT_LOAD_H	LITERAL1
AX_PRESENT_VOLTAGE	LITERAL1
AX_PRESENT_TEMPERATURE	LITERAL1
AX_REGISTERED_INSTRUCTION	LITERAL1
AX_PAUSE_TIME	LITERAL1
AX_MOVING	LITERAL1
AX_LOCK	LITERAL1
AX_PUNCH_L	LITERAL1
AX_PUNCH_H	LITERAL1

